|-----------------------------------------|
|--------------                           |
|----                                     |
|                          |         |    |
|                          |         |    |
|                |         |              |
|                -----------              |
|                                         |
|                |-------------|          |
|                |             |          |
|         -------|             |          |
|                                         |
|-----------------------------------------|